100000000000000000000000000000000000000000000000000000000000000000000000000000000000000000000000000000000000000000000000
000000000000000000000000000000000000000000000000000000000000000000001000000000000000000000000000000000000000000000000000
000000000000000000000000000000000000000000000000000500000000000005000001000000000000000000000000000000000000000000000000
000000000000000000000000000000000000000000000000000111111111111111000001000000000000500000000050000000000000000000000000
000000000000000000000000000000000000000000001111100000000000000000000001000000000000111111111110000000000000000000000000
000000000000000000000000000000000000000001000000000000000000000000000001000000000000000000000001000000000000000000000000
000000000000000000000000000000000000101000000000000000000000000000000010000010010000000000000000000000000000000000000000
000000000000000000000000000000000000000000000000000000000000000000000010040010000000000000000000000000000000000000000000
000000000000000000000000000000000110000000000000000000000000000000000011111110000000000000000001000000000000000000000000
000000000000000000000000000000000000000000000000000000000000000000000000000000000000000000000010000000000000000000000000
000000000000000000000000000001100000000000000000000111100000000000000000000000000000000000000100000000000000000000000000
000000000000000000000000000000000000000000000011000000000001000000000000000000000000000000001000000000000000000000000000
000000000000000000000000010000000000000000000000000000000000500000000000000000000000000000500000000000000000000000000000
000000000000000000000011110000000000000000000000110000000000011111111111111111111111111111100000000000000000000000000000
000000000000000000000000000000000000000000111000000000000000000000000000000000000000000000000000000000000000000000000000
000000000000000000000000000100000000000000000000000000000000000000000000000000000000000000000000000000000000000000000000
000000000000000000000000000000000000000010000000000000000000000000000000000000000000000000000000000000000000000000000000
000030000000000000000000000000100000000000000000000000000000000000000000000000000000000000000000000000000000000000000000
000000000000000000000000000000111111111000000000000000000000000000000000000000000000000000000000000000000000000000000000
000000000000000000000000000000000000000005000000000000000000000050000000000000000000000000000000000000000000000000000000
000000000000000000000000000000000000000001111111111111111111111110000000000000000000000000000000000000000000000000000000
000000000000000000000000000000000000000000000000000000000000000000000000000000000000000000000000000000000000000000000000
000000000000000000000000000500000000000000000000000000000000000000000000000000000000000000000000000000000000000000000000
000000000000000000000000000111111111111111111111111111111100000000000000000000000000000000000000000000000000000000000000
000000000000000000000000000000000000000000000000000000000000000000000000000000000000000000000000000000000000000000000000
000000000000000000000000000000005000000000000000000000000000000000000000000000000000500000000000000000000000000000000000
000000000000000000000000000000001111111111111111111111111111111111111111111111111111100000000000000000000000000000000000
100000000000000000000000000000000000000000000000000000000000000000000000000000000000000000000000000000000000000000000001
100000000000000000000000000000000000000000000000000000000000000000000000000000000000000000000000000000000000000000000001
111111111111111111111111111111111111111111111111111111111111111111111111111111111111111111111111111111111111111111111111
