000000000000000000000000000000000000000000111111111111111100000000000000000000000000000000000000000000000000000000000000
000000000000000000000000000040000000000000000000000000000000000000000000000000000000000000000000000000000000000000000000
000000000000000000000000000111000000000000000000000000000000000000000000000000000000000000000000000000000000000000000000
000000000000000000000000000010000010000000000000000000000000000000000000000000000000000000000000000000000000000000000000
000000001000000000000000000010000000000000000000000000000000000000000000000000000000000000000000000000000000000000000000
000000000000000000000000000010000000000000000000000000000100000000000000000000000000000000000000000000000000000000000000
000000000000100000000000000010000000000000000000000000000000000000000000000000000000000000000000000000000000000000000000
000000000000000000000000000010000000000000000000000000100000000000000000000000000000000000000000000000000000000000000000
000000100000000010000000000010000000000000000000000000000000000000000000000000000000000000000000000000000000000000000000
000000000000000000000000000010000000000000000000000000000000000000000000000000000000000000000000000000000000000000000000
000000000000000000000000000010000000000000000000000000000000000000000000000000000000000000000000000000000000000000000000
000000000000000000000000000010000001000000000000000000000000000000000000000000000000000000000000000000000000000000000000
000000000000000000000000000010000000000000057000000000000000000000000000000005000000000000000000000000000000000000000000
000000100000000000000100000010000000000000001111111111111111111111111111111110000000000000000000000000000000000000000000
000000000000000000000000000011100000000000000000000000000000000000000000000000000000000000000000000000000000000000000000
000000000000000000000000000000000000000000000000000000000000000000000000000000000000000000000000000000000000000000000000
000000000000000000000000000000000000000000000000000000000000000000000000000000000000000000000000000000000000000000000000
000000000000000000000000000000000000000000000000000000000000000000000000000000000000000000000000000000000000000000000000
000000100000000000000000015000000000000000000000000000000060000000000000000000000000000000000500000000000000000000000000
000000000000000000000000000111111111111111111111111111111111111111111111111111111111111111111000000000000000000000000000
000000000000000000000000000000000000000000000000000000000000000000000000000000000000000000000000000000000000000000000000
000000000000000000000000000000000000000000000000000000000000000000000000000000000000000000000000000000000000000000000000
000000000000000000000000000000000000000000000000000000000000000000000000000000000000000000000000000000000000000000000000
000000100000000000000000000000000000000000000000000000000000000000000000000000000000000000000000000000000000000000000000
000000000000000000000000000000000000000000000000000000000000000000000000000000000000000000000000000000000000000000000000
000000000111111111111111111111111111110000000000000000000000000000000000000000000000000000000000000000000000000000000000
000000000000000000000000000000000000001111111111111111111111111111110000000000000000000000000000000000000000000000000000
100000000000000000000000000000000000000000000000000000000000000000001111111111111111111111000000000000000000000000000001
100000000000000000000000000000000000000000000000000000000000000000000000000000000000000000000000000000000000000000300001
111111111111111111111111111111111111111111111111111111111111111111111111111111111111111111111111111111111111111111111111
